시/도,종합병원,병원,요양병원,군병원,합계,
서울,58,233,126,1,418,
부산,29,146,201,1,377,
대구,16,110,65,0,191,
인천,19,63,76,0,158,
광주,22,79,68,0,169,
대전,10,48,53,1,112,
울산,8,44,43,0,95,
경기,61,276,334,6,677,
강원,15,45,33,4,97,
충북,13,39,52,1,105,
충남,13,46,93,2,154,
전북,13,86,89,0,188,
전남,26,77,86,1,190,
경북,19,82,119,2,222,
경남,25,144,139,2,310,
제주,6,7,10,0,23,
세종,0,1,7,0,8,
합계,353,1526,1594,21,3494,
